0,1,0,0,0,0,0,1,0
0,1,1,0,0,0,0,1,0
0,0,1,1,0,2,p,1,0
0,0,0,1,3,1,1,0,0
0,0,0,0,0,0,0,0,0
0,0,1,1,0,0,0,0,0
0,1,0,0,1,1,1,1,0
1,0,0,0,0,0,0,1,0
1,q,0,0,0,0,0,1,1
