0,0,1,0,0,0,0,1,0
0,0,1,0,0,0,p,1,0
0,0,1,0,0,2,1,1,0
0,0,1,1,1,1,1,1,0
0,0,0,0,0,0,0,0,0
0,0,0,0,0,0,0,0,0
0,0,0,0,1,0,0,0,0
0,1,0,0,1,0,0,1,0
1,1,q,1,1,0,0,1,2
